深海少女 - ゆうゆ/初音ミク
Hero’s Come Back!! - (TV动画《火影忍者疾风传》OP1) - nobodyknows+
キミがいる - (有你) - Galla
Cage <NTv> - (剧场版《机动战士高达NT》 插入曲 / 劇場版『機動戦士ガンダムNT』挿入歌) - SawanoHiroyuki[nZk]/Tielle
花に亡霊 - (花上亡灵) - ヨルシカ
Departures〜あなたにおくるアイの歌〜 - (Departures ~赠于你的爱之歌~) - EGOIST
ただ君に晴れ - (仅予你的晴天) - ヨルシカ
サマータイムラブ - (夏日爱情) - Shiggy Jr.
101匹目の羊 -めぐみん Ver.- - 高橋李依
ライラック - Apo11o program/森永真由美
Red Battle - 高橋李依/豊崎愛生
異世界ガールズ♡トーク - (TV动画《异世界四重奏》片尾曲) - 原由実/雨宮天/高橋李依/悠木碧
金曜日のおはよう -Another Story- - (星期五的早安) - 雨宮天
おうちに帰りたい - (好想回家) - 雨宮天/高橋李依/茅野愛衣
ちいさな冒険者 - (小小冒险者) - 雨宮天/高橋李依/茅野愛衣
my sweetest one - Aimer
Torches - (火炬) - Aimer
My Dearest (Album Mix) - supercell
新宝島 - (新宝岛) - サカナクション
All Alone With You - (TV动画《心理测量者》一期ED2:TVアニメ「PSYCHO-PASS サイコパス」第1期ED2) - EGOIST
Sun is coming up - (太阳正在升起) - Shiggy Jr.
oyasumi - (晚安) - Shiggy Jr.
baby I love you - Shiggy Jr.
素直になれたら - (若能更加直率) - miu-clips
Miku - Anamanaguchi/初音ミク
Light up my LOVE!! (feat. moco) - onoken/moco
New World (Completed Version) - 鎌田純子
夏、終わらないで。 - (夏天、请不要结束) - BiBi
小さな恋のうた - (小小恋歌) - ハンバート ハンバート
季節は次々死んでいく - (季节陆续死去 ) - amazarashi
summertime - cinnamons/evening cinema
恋のシグナルRin rin rin! - 飯田里穂
君は口内炎 - (你是我的口腔炎) - ef
Fly - Softly
日が落ちるまで - (直到日落时) - ハンバート ハンバート
傘 - 竹仲絵里
河 - 池田綾子
彼女は旅に出る - (她踏上了旅途) - 鎖那
いきのこり●ぼくら - (残存的 ● 我们) - 青葉市子
原風景 - mamomo/丘咲アンナ
すてきなメゾン feat. 玉城ティナ - tofubeats/玉城ティナ
No.1 - (日剧《掟上今日子的备忘录》主题曲) - 西野カナ
LIFE - (TV动画《死神》ED5 / TVアニメ「BLEACH」ED5テーマ) - YUI
さよならの夏～コクリコ坂から～ - (告别之夏~虞美人盛开的山坡~) - 手嶌葵
僕は君に恋をする - (我爱上了你) - Naomile
Nico - advantage Lucy
パズル - (拼图) - ENE
六等星の夜 (from Live at anywhere) - (六等星之夜) - Aimer
ちいさなラズベリー - (小小的木莓) - 南壽あさ子
会いたい - (想见你) - Naomile
Lemon - (日剧《非自然死亡》主题曲) - 米津玄師
カントリーロード - (乡间小路) - 伊藤サチコ
八月 - 七尾旅人
小さな恋のうた - (小小恋歌) - Naomile
初恋の頃 - (初恋之时) - 手嶌葵
ラタムニカ - 藤原さくら
ㅤ - Setton
人として - (生而为人) - SUPER BEAVER
蝶々結び - (蝴蝶结) - Aimer
Sunshine after the rain - AMADORI
ラプンツェル（Cover 初音ミク） - (长发公主 Rapunzel) - 芝麻Mochi
おなじ话 - (重复的话) - ハンバート ハンバート
今晩はお月さん - (今晚月色真好) - ハンバート ハンバート
ALIVE - RAM WIRE
カタオモイ - (单相思) - Aimer
あめをゆかにしいて（Cover 初音ミク） - 米白
灰色と青 - (灰色与青) - 米津玄師/菅田将暉
Dancing People - キクチリョウタ
いつも何度でも - (永远同在) - 竹仲絵里
はじまりの日 - (与你邂逅的那一日) - じょん
东京夏日相会-含念白（翻自 GUMI×flower） - Akie秋绘/Kiko
風化する教室 - (风化的教室) - きのこ帝国
僕が死のうと思ったのは - (曾经我也想过一了百了) - 中島美嘉
桜色舞うころ - (樱花纷飞时) - 中島美嘉
无名之歌（翻自 镜音） - 十九遥
I hate me - (I hate me) - Lily.μ
アスノヨゾラ哨戒班。明日的夜空哨戒班（Cover IA） - Akie秋绘/夏璃夜
Break Beat Bark! - (剧场版《刀剑神域 -序列之争-》插曲) - 神田沙也加
5年後･･･ - (五年后) - ONE☆DRAFT
Alice（Cover 古川本舗） - 米白
Life Is Like A Boat - (生如行舟) - Rie fu
心拍数♯0822（翻自 初音ミク） - Akie秋绘
longing - (剧场版《刀剑神域 -序列之争-》插曲) - 神田沙也加
ほろよい - (微醺) - 辻詩音
7日間. - (7日间) - saji
Stay Gold - 大橋トリオ
瑠璃色の地球 - (琉璃色的地球) - 広瀬すず
Forever Friends - (动画电影《升空的焰火，从下面看还是从侧面看?》插曲) - Daoko
恋をしたのは - (关于恋爱的事) - aiko
夕顔 - (月光花) - 能登麻美子
打上花火 - (动画电影《升空的焰火，从下面看还是从侧面看?》主题曲) - Daoko/米津玄師
Brave Shine - (勇气之光) - Aimer
生きていたんだよな - (她曾活过啊) - あいみょん
Lost in wonderland - 辻詩音
up to you - Softly
おなじ話 - (同样的话) - ef/黒沢大佑
なんでもないや（翻自 Radwimps） - (没什么大不了的) - Akie秋绘
恋 - (日剧《逃避虽可耻但有用》主题曲) - 星野源
雨き声残響 (カバー) - (雨声残响(翻唱)) - すぃ
Darma Grand Prix - RADWIMPS
HIRUNO HOSHI - (白日星辰) - illion
冷めたスープ - (冷掉的汤) - 柴田淳
裏表ラバーズ×ロストワンの号哭 - (里表情人×Lost one的号哭) - 初音ミク/鏡音リン/wowaka/Neru
your song - SUPER BEAVER
私の言葉 - (我的话语) - 久保ユリカ
POSE - 辻詩音
メトロノーム - (节拍器) - 米津玄師
あやとり - (翻花绳) - 諫山実生
おとなの掟 - (成人法则) - Doughnuts Hole
アサガオの散る頃に - (牵牛花凋零之时) - ウォルピスカーター
No title - (无题) - Reol/Giga
最大公約数 - RADWIMPS
Cynic - (讽世者) - 闇音レンリ/ポリスピカデリー
あいうえお - (a i u e o) - Happy End
Call of Silence - 澤野弘之/R!N/Gemie
最高の片想い - (弥足珍贵的单相思) - タイナカ彩智
Future - Special Favorite Music
また君と - (再度和你) - JAY'ED/Ms.OOJA
No Logic - ジミーサムP/ろん
愛を伝えたいだとか - (想要传达爱什么的) - あいみょん
アストロノーツ - (宇航员) - 椎名もた/ちょまいよ
AKARI - (光芒) - Every Little Thing
春に一番近い街 - 真栗
Tara-Reba - androp
メジャーデビュー - NakamuraEmi
笑い話 (piano ver.) - (Waraibanashi (piano ver.)) - ラブリーサマーちゃん
誰よりも - 山根万理奈
ヒマワリが咲く予定 - (向日葵将绽放) - NakamuraEmi
ルミネセンス - (发光) - ラブリーサマーちゃん
懺悔録 - (忏悔录) - 黒木渚
ダイニング - 植田真梨恵
3355411 - 小南泰葉
sub/objective - (sub/objective) - たなか
夜空ノムコウ - (夜空彼岸) - Sotte Bosse
茜さす - (夕晖) - Aimer
Happy Halloween - 柊優花/鎖那
嘘つき - (骗子) - 藤原さくら
メランコリック - (忧郁 Melancholic) - 山根万理奈
NO-MAN - 小南泰葉
タナタロ - (塔塔罗) - 鎖那
花降らし - (落花) - ぱじ
暧昧さ回避 - (回避暧昧) - ポリスピカデリー/闇音レンリ
○+● - (Truth + Lie) - kous/ef
D.C. - bassy/セリユ
カランコロン - (卡兰科隆) - 山崎あおい
831143 - nero
カノジョ - (她) - THE MUSMUS
ワールド・ワイド・ボクシステム - (遍及全球的自我系统) - Annabel
愛してる - (我爱你) - 高鈴
世界は恋に落ちている -acoustic version- - (我的世界已坠入爱河) - かぴ
天ノ弱 - (天之弱) - 鹿乃
ハロ/ハワユ - (你好，近来如何) - ナノウ/鹿乃
アイロニ - (反语) - 鹿乃
sweets parade - (TV动画《妖狐×仆SS》第6集片尾曲) - 花澤香菜
月が泣いてる - (月亮在哭泣) - つじあやの
Rolling star - (TV动画《死神》OP5 ) - YUI
猫になりたい - (想要变成猫) - つじあやの
絆 - miu-clips
アイロニ (双声道版) - (反语) - 鹿乃/*菜乃
ぼくらのレットイットビー - (让我们顺其自然) - はりーP/初音ミク
恋愛サーキュレーション (双声道版) - (恋爱循环) - 花澤香菜/釘宮理恵
GLORIA - (格洛里亚) - YUI
again 〜YUI Acoustic Version〜 - YUI
釘宮がサザエさんのBGM - 釘宮理恵
kirari futari - mamerico
コンプリケイション - (复杂人生) - ROOKiEZ is PUNK'D
裏切りの夕焼け - 茶理理
缲り返し一粒 リンver - (往返的一粒) - 鹿乃
bouquet - 初音ミク/doriko
あの頃～ジンジンバオヂュオニー～ - (那个瞬间~紧紧拥抱你~) - whiteeeen
バースデーソング - (生日快乐歌) - Goose house
Stay Alive - (TV动画《Re:从零开始异世界生活》ED2:TVアニメ「Re:ゼロから始める異世界生活」後期エンディングテーマ) - 高橋李依
クライヤ - (Cryer) - 鹿乃
東京 - 山崎あおい
庭園にて。 - (在庭院中) - acane_madder
美しきもの - (美丽之物) - Sound Horizon
us feat. ゆきな - (我们) - 澤田空海理
My Truth～ロンド・カプリチオーソ - 種田梨沙
冬のエピローグ - (冬之终章) - Goose house
Release My Soul - Aimee Blackschleger
なわとび - (跳绳) - 久保ユリカ
BLUE <pfs> - 澤野弘之
いけないボーダーライン - (禁忌的边界线) - ワルキューレ
空の欠片 - (TV动画《电脑线圈》ED1 ) - 池田綾子
好想被钉宫辱骂啊 - 釘宮理恵
夜の国 - (夜之国) - Annabel
crossroad - YUI
みんなだいすきのうた - (最喜欢大家的歌) - 三上枝織
The Reluctant Heroes - 澤野弘之/mpi
Harmonia - ミト
Rally Go Round - (TV动画《伪恋》第二季片头曲 ) - LiSA
aLIEz - (TV动画《ALDNOAH.ZERO》ED2:TVアニメ「アルドノア・ゼロ」ED2) - 瑞葵(mizuki)/SawanoHiroyuki[nZk]
だんご大家族 - (团子大家族) - 茶太/真理絵/くない瓜/Rio/Morrigan/藤枝あかね/加藤恒太
ninelie (TV size) - (TV动画「甲铁城的卡巴内瑞」ED) - Aimer/EGOIST
My Truth～ロンド・カプリチオーソ - (我的真相～隆多·卡普里奇奥索) - ENA☆
一番の宝物 (Original Version) - (最为珍贵的宝物) - karuta
Brave Song - (TV动画《天使的心跳》ED1) - 多田葵
QUESTION - (TV动画《暗杀教室2》片头曲) - 渕上舞/洲崎綾/岡本信彦/逢坂良太/浅沼晋太郎
からくりピエロ - (活动小丑) - Gero
歌舞伎町の女王 - (歌舞伎町的女王) - 椎名林檎
スキキライ (feat. そらる & ろん) [ギガP REMIX] - HoneyWorks/そらる/ろん
私の嘘～PianoSolo - (我的谎言) - 横山克
名前のない怪物 - (无名怪物) - EGOIST
