特别的歌给特别的你 - 黎明
半点心 - 草蜢
Honey Honey - 孙燕姿
风吹麦浪 - 李健
心痛的感觉 - 林志炫
夜夜夜夜 - 齐秦
心墙 - 郭静
我在人民广场吃炸鸡 - 阿肆
安和桥 - 宋冬野
斑马，斑马 - 宋冬野
莉莉安 - 宋冬野
鸽子 - 宋冬野
关忆北 - 宋冬野
私奔到月球 - 五月天/陈绮贞
连名带姓 - 张惠妹
You Are Not Alone - Michael Jackson
Making Love Out Of Nothing At All (Live) - (原唱：Air Supply) - 林志炫
玫瑰 - 贰佰
飞花 - 李克勤
一生不变 - (1989年亚洲电视剧《蓝月亮》主题曲) - 李克勤
烦恼歌 - 张学友
慢慢 - 张学友
吻别 - 张学友
我是真的爱你 - 张宇
趁早 - 张宇
囚鸟 - 张宇
深海少女 - ゆうゆ/初音ミク
Just Dance - Lady Gaga/Colby O'Donis
Bad Romance (Radio Edit) - Lady Gaga
Poker Face - Lady Gaga
西厢 - 后弦
恶作剧 - 林依晨
七月七日晴 - (台视九点档偶像剧《心动列车》片尾曲) - 许慧欣
我的果汁分你一半 - 花儿乐队
Tell Me - 潘玮柏/徐洁儿
爱如空气 - 孙俪/柏菲音乐
恰似你的温柔 - 蔡琴
天后 - 陈势安
护花使者 - 李克勤
香草吧噗 - 南拳妈妈
说爱你 - (电影《空中拜金女》中文主题曲) - 蔡依林
可不可以不勇敢 - 范玮琪
睫毛弯弯 - 王心凌
成全 - (电视剧《梦想成真》片头曲) - 刘若英
As Long as You Love Me - Backstreet Boys
我是一只鱼 - (和讯广告主题曲) - 任贤齐
不要说话 - 陈奕迅
当爱在靠近 - 刘若英
为你我受冷风吹 - 林忆莲
漫步人生路 - 邓丽君
最初的梦想 - (选自“韩剧大长今”) - 范玮琪
我是真的爱上你 - 王杰
我的天空 - 南征北战NZBZ
南山南 - 马頔
雨爱 - (电视剧《海派甜心》片尾曲) - 杨丞琳
偏爱 - (电视剧《仙剑奇侠传三》插曲) - 张芸京
小酒窝 - (Dimples) - 林俊杰/蔡卓妍
追梦赤子心 - (2013《快乐男声》主题曲) - GALA
如果这都不算爱 - 张学友
真的爱你 - (Truly Love You) - Beyond
走马 - 陈粒
不怕不怕 - 美美jocie
我怀念的 - 孙燕姿
浮夸 - 陈奕迅
光辉岁月 - Beyond
快乐崇拜 - 潘玮柏/张韶涵
忽然之间 - 莫文蔚
她来听我的演唱会 - 张学友
平凡之路 (Live) - 朴树
遇见 - (电影《向左走向右走》国语版插曲) - 孙燕姿
海阔天空 - (Boundless Oceans, Vast Skies) - Beyond
我爱的人 - 陈小春
明天过后 - 张杰
情非得已 - (电视剧《流星花园》主题曲) - 庾澄庆
他一定很爱你 - 阿杜
北极星的眼泪 - (电视剧《微笑Pasta》片尾曲) - 张栋梁
当你孤单你会想起谁 - 张栋梁
月半弯 - 陈坤
欧若拉 (Live) - 张韶涵
希望 - (韩剧《大长今》主题曲) - 陈慧琳
画心 - (电影《画皮》主题曲) - 张靓颖
童话 - 光良
我最亲爱的 - 张惠妹
曹操 - 林俊杰
笔记 - 周笔畅
这，就是爱 - 张杰
江南 - (River South) - 林俊杰
我很快乐 - 刘惜君
爱要坦荡荡 - 萧潇
因为爱情 - (电影《将爱情进行到底》主题曲) - 陈奕迅/王菲
痴心绝对 - (电视剧《爱上痞子男》主题曲) - 李圣杰
相见恨晚 - 彭佳慧
认真的雪 - 薛之谦
狮子座 - 曾轶可
Gangnam Style (강남스타일) - (江南Style) - PSY
没那么简单 - (电视剧《左手亲情右手爱》主题曲) - 黄小琥
黄昏 - 周传雄
我们的爱 - F.I.R.
偏爱 - (电视剧《仙剑奇侠传三》插曲) - 张芸京
爱情转移 - (电影《爱情呼叫转移》主题曲) - 陈奕迅
好心分手 - (DUET WITH 王力宏) - 卢巧音/王力宏
记事本 - (选自“我的秘密花园2”) - 陈慧琳
勇气 - 梁静茹
星语心愿 - (电影《星愿》插曲) - 张柏芝
隐形的翅膀 (Live) - 张韶涵
传奇 - 王菲
不得不爱 - 潘玮柏/弦子
那些年 - (电影《那些年，我们一起追的女孩》主题曲) - 胡夏
大城小爱(Live) - 王力宏
秋天不回来 - 王强
分手快乐 - 梁静茹
齐天大盛 - 至上励合
降临 - 至上励合
繁星 - 至上励合
棉花糖 - 至上励合
Right Here Waiting - 阿杜
